20
20
L..#......#......#..
.#.............#....
..............#..##.
.......#..#....#....
.##.#....#.##...#.#.
......###......#....
..##.#....##...#...#
..#...##.........#..
..#.###.....#...#.#.
...#...#.....###....
#.#..#........#.#..#
....#.....##....#...
....#..#..##.....L..
...#..#.####.......#
...#...##...#.#.....
..##...........##.#.
...#.....##.#..#.#..
..#.###....#........
#...#..#...#..#....#
...#....##.#...##.X#
