45
45
..###.#.#..#.##......#...#.....#.#.#....#..#.
......##.####.#...####...##.##...#..........#
##.#.#.#.#.###.....##.#.##.#.##.##.###.#.#...
..#....#.#..........##.#.##..#...#..###.#....
#.#......###....#.#.#.##.#..#.##.##......#.#.
#.#..#.#.#..#......##.......##...#..#.#....#.
#..#...#...#.##..#.....#...#....#.#.#.....###
###...##..#..##..##..##.#.####..#....##......
.......#.#...#.###.#..#.#...#..#.#.###.......
..###..#..#.#.#...#.......#..##.#..#.##..##..
.........####.#..#...####..##....#.#...#..#.#
#####.....#....#.###.......#....#.#..##.#..#.
........#..........#.....#.#...#.#...#.#...##
...##...##..#.#......#.....#......#......##..
..#..###.##.#....#........#.#..#....#.##..###
.##...#............#....###...#.###..##...#.#
...#.#.#.##.#..###.##...#.#.#......###...##..
.#.#..#..#.#.#..#.#...#.#....#.......#......#
.#.......####....#..#..#.#..###.#.##.##....#.
##..#...#..#X..#........#....#........###..#.
.#.####.###.###..#.###.......##.#..#.#......#
..###...#.......#..#.######...#..##....#.....
.......#...#..##.#.....####.##...#..#..#.#.#.
..#......###...#.##..#.....#..#...#......##..
....#..#..#.#..#...#....#...#...###...#.##.##
#.#..#.#...#.#..##.###....#..##......#...#...
.#...##.##..#.#....#.....#..#.#########......
#...#.##.#..##...#...#.##.......##.......#...
##.#.#..###...##.#.#..##.###..#.##..#...#..#.
#.....#...##.......#.#...#.###.#.#.##..#.....
#.....#...........#..#......#.#.....#.#.##.#.
............#.#.###.###..#.#...#.##.##...#..#
.#....##.##..#..###.#..#.....##.....#.##..#..
..#.#.#.#.#........##.#...#.....#####......##
...##..#.#.##....#.......#..#....####...####.
......#..#..#....##..##...#...####.##.#.#...#
.#.#.##......#.#.#....#.#.####.#.#.......#.##
....##.##.#####.....##..#.......##...##.....#
.#....#.##..............#.....#...#...#..#...
........#..####..##........##.#..#.#.###.#.#.
.#..#.#..#....##.###.L.####........###.....#.
#.###.....#.....#...#.#..#.....#..#..###..#.#
..#............#.....#.##.......##.##..##...#
#.#.....#.#..#..##....#.....##.##.###.#...#..
.#...#.##..#..###...##..#.#.#..#..#.###.#....
