30
30
...#..#.#......##.####.#......
#.##...#...#.....##.#.........
..#..#.......##....#..#....#..
.#.#..#.##.....#.#...#.#...#.#
##.##.#.#...#.#.............#.
.##.......##..L..##.##..###..#
...##.#.#.####..#..........##.
.#....#.##...#..#.......#...##
###....##...###....##........#
...#...#..#...#..#......##..#.
..#..#..#.......#.......#..#..
..#..#.......#...#.#...#..#.#.
##.........#...##......#.#....
#..#......#....#.#......#.#.#.
.##.#..#....#..........#..##.#
#......#...#....#...#.##..#...
...#.##.X#.#...###.......##.#.
#..#...#....#....###..#.....#.
.#.....#.#.##.#.#...#..#.#..#.
...#.#....##...........#.###..
..#..#......##...#....##.#.###
#..#..##....##..#.#...###...#.
...........#.....#.#..#..#..##
....#......#.#..#.#..#..#.....
..#....#....#..#...#..#...#...
#..#.#.....#...##.##.#.#...##.
#......##.#..#.#..##....#...##
.#..##....#.......##....#...#.
....#...###..#...#.#.#.#..##..
#####.#.####.##....##.###.#..#
