40
40
###...#...#.#..#.#.##..##..#..##...##.##
.#...#.###.X...#........#..#.....#.##..#
##.....##...##.#..#########.......#..#..
..#....#...##....#..#.#..#..#.#..#.#.#..
..##..#.#.#...#..#...##..##.......##..#.
...#.....#..#.......###..##....##....##.
.#...#..##.....#...#....##.....#...####.
...#.#.#.........##...####.#.#....##..#.
..#..............##..##.......##.#.#....
.##.......#..#.....#.........##.#...##..
#....##...#.#.###.#...#....#.##.#.....##
.#.#.#..#.....#..##.##....#.###..##.#...
.#...#...#..#....#....#....#...#.#......
#........###...#.#..#.#...##....#..#....
.......#.......#...##...#..#......#....#
##.###.#.###....#..##.#.#....#...##...#.
.....#.#..#.....#.#.##.#........#..#.###
.#......##.#....#.##...#....#...#...#.##
.#......#..##.#.......##..##..#....#.#..
.#..#...#.#..#....#........#.#.#..#...#.
#.....#.#.#..#.......#..#.#..#.....####.
..#....#.#####.#..##....#..#.....#.#.###
#....#.#......#.#..#.#####.#....##..##..
..#...#...##.#.#.....#.#.##..#.....#...#
..####....#.......#.##..##...##...#..#.#
#.#..#.#..#####........##..#...#.#..#...
#...###...##.##.##..#.##.#.#.#.#....#...
...#.....#...##....##..#.....#####..#..#
#....####...#.###..#...#.###..#.....##..
.......#.......##.#...#.###..#..##..##.#
##.##...##......#..####..#.#.#......#..#
##..#..#..#.##...####....#......#..#....
#.....#...#..#....#..#.#.#.#.#..#..###.#
#.##.#..#...#.#...#..##.##..#.#..L###.#.
#.#.....##..#.##....#.#....#...##..#...#
#.#.....##.....#.###.#.#...#.......##.#.
..#.#..#.#.#..###.#..####.##.#...##.#..#
#.......#..#......###.........#.....#..#
...#.#####..#.#..#.#......##..#...#.#...
...#....###..#.......#.#......####.#...#
