42
42
#....#..#.....#####.#..#.#..#.##.X.....#..
###...#.....##..#..........#.#....#.##...#
.#............#.........##.##..#.....####.
...#.##..#....#..#.....###.#..#.....##.#..
....#..##....###....##....##.#..###.....##
..#...#....###..#.#.#.##...###..#...#...#.
.####.#....#.#...#..#...#.#...#.#.#....#.#
.##......##.#.#..#..#.#.#..#..#..#..#....#
...##.#..#####..#....#..##.#....L..#.#..#.
...#.#.####...#.#..#.#.#..#..##.....#..#.#
#...##....#.#...#.#....###...........#..##
..#..#..##.#....#...#..#....#....#.......#
......##..........###..#......#..#..#...##
#...##.#...####..#.#..#..#...###...##.###.
..#.#...#..##.#......#....#.......#.##..#.
.##....#.......#..#.#..#...#.#.##...#...#.
...#..##..#........####..#....#.#.#.....#.
...##.###.#..#.....#..#...#.###......#.#.#
#....#.......#..#.#.#..#...#.#.##......#..
.#......##.###...##...#..####...#......#..
.####.#...#.#.##..#..#.#.#.#..#.#..##..##.
##..####.#..##..##...#...##.###..#.#.#....
..#..##....#.#.....#.#...##.#....#.###..#.
#.#...##......#.#..##.....##..###..###.#..
....#.....#.##.#..#........#.#.....#....##
.......###.#..###...#.#.#...#..#..#.#####.
##..#.##...#.#..#.###..#...#......##.#.#.#
.##...#.#...#.#.....#....#...#...####.#..#
#..#....................#.......##.#..##..
.##..#..##.........#.....#.......#..#.....
.#.#.#.....#....#.###.#....#.##.##...#.##.
..##.#...#.#..#.####..####.#..##...###....
....#..#..#..##..##...#..##.#.#.##....#..#
#..#.....#.....#...........#...#.....#....
....#..#...#....##...#..##...#...#...#.#..
##....##..#...###...##.#...........#..###.
.....##...#.###..#.##.............####..#.
..##...##.###..##..........#.#.#...#..#.##
#..#.#..##..#....#.......#.......#.#.....#
#..#...#......#.#.....#.#.#...##.##..##..#
.##.######..##.....##.#........#..##..#..#
#..###.##..#.####...#..#.##.....###..#.#..
