35
35
...#....##...........#.....#.###.##
..............#.#..#...###.#.##...#
...L###.#...#.#..#..............##.
.###.#..#..#.#.#..#.#.#.###...#....
#....##...#..##.#.#..#.##..###....#
..#..###.##......#..#..#..#......##
#.##..#......#..#..#.....#...#.#.#.
#.#.#........##...#....#...###.....
...#.....#.#...###......#......#...
....#....#..#........#.#.##....#...
..##......####.#####..#...#..##...#
###.#.#.#.....##...##.#..#..#.#....
.#..#...###.#.#.......##.......#...
.#...####..##..#.#..#.......##.....
..#....##....##...#.#.....#.#..##..
#..#..#...#.#.#.#.#....#.#..##.####
...###.###..#..#.#..#.#.#...#X.#...
#.#.......#...#.#........#....###..
.#......#.##...#####........#.##...
.......##...###..#...##.#.##..##..#
.......#.#..#......#..#....#..##...
.#.#..#...##..##....#.#.#####.##...
###....#...#.#.#..#####..#.#.#.#...
#....##.#.....................##...
..##.#.#.#.#.#.#........#..###..#.#
..#.#....#.......#................#
....##...#.#....#.#.####..###..##.#
###....###..##.####.##...#.##..#...
...#......##..###.#.#.#.#..#...#..#
.#...#....###.#.#.#.#.#...#...##.##
#.#....#....#.##.#..#.#.#.......##.
....#....#.#.##.#.#...#.....#..#...
..#.......##.........##.##.....#.#.
#..###...#.#####..#.#..##....#...#.
#...#..####..##....#...........#..#
