20
20
###.##.#.#.X...##..#
..##.##.#....#.#....
..#..###....#..#.#..
#...###..#.####.#...
.##.#L....#.#.#...#.
.##.##...####.#..##.
...###.##.###.######
#..##.......##.#####
.#.....###.#..#..#..
#....##.###..#..####
#....##..##..##.#.#.
...##.......#..#....
..#..##...#.#..#.##.
#.#.......#.#..#....
.#.#.##.#.####.##.#.
.#.#....##########..
......##..#......#..
.#.#.#..###...#.....
#..##..#.##...######
....##..#..#.##.###.
