5
20
......#..#........#.
...#..#..#........#.
.#.###...#........#.
......#...#.......#.
L........#..........