5
20
.....#.....#####.#..
....#.#...#......X#.
.@.....#....####.#..
#####...######......
L...........#.......
