5
20
...........#####.#..
....#.#...#.......#.
.......#....####.#..
#####...######......
............#.......
